1111111111
1E00000000
10011000C1
1001100P01
1111111111