111111
10P001
100C01
10P0E1
111111
