111111
10P0001
1C0001
1000E1
111111
