111111
10P0C1
1E0001
1000E1
111111
