1111111111
1000000001
1001100001
100110AP01
1111111111