1111111111
1C001E0001
10011000C1
1001100P01
1111111111