111111111111111111111111
1C0000000CCCC00010000CC1
1C00CCCCCCCCC11C0CC0C1C1
11CC11CCPCCC0100100001C1
1CCC11CC1100010E10011CC1
1CCC11CCCCCC010010000CC1
111111111111111111111111
