1111111111111
1C000C0000101
1E0110000C101
1001100P00001
1111111111111
