111111111111111
1C0000000000CC1
1C000000000C1C1
1ECC11CCPCCC1C1
1CCC11CC1111CC1
1CCC11CCCCCCCC1
111111111111111
