1111111111
1000000001
1001100001
1001100P01
1111111111