111111111111111
111111111111111
11C000C00001011
11E01100P0C1011
110011000000011
111111111111111
111111111111111
