111111
10P001
1C0001
1000E1
111111
